"a" = (/turf/wall,/area)
"b" = (/turf/floor,/area)
"c" = (/mob,/turf/start,/area)

(1,1,1) = {"
aaaaaaaaaaaaaaaaaaaaaaaaaaaaaaaaaaaaaaaaaaaaaaaaaa
abbbbbbbbbbbbbbbbbbbbbbbbbbbbbbbbbbbbbbbbbbbbbbbba
abbbbbbbbbbbbbbbbbbbbbbbbbbbbbbbbbbbbbbbbbbbbbbbba
abbbbbbbbbbbbbbbbbbbbbbbbbbbbbbbbbbbbbbbbbbbbbbbba
abbbbbbbbbbbbbbbbbbbbbbbbbbbbbbbbbbbbbbbbbbbbbbbba
abbbbbbbbbbbbbbbbbbbbbbbbbbbbbbbbbbbbbbbbbbbbbbbba
abbbbbbbbbbbbbbbbbbbbbbbbbbbbbbbbbbbbbbbbbbbbbbbba
abbbbbbbbbbbbbbbbbbbbbbbbbbbbbbbbbbbbbbbbbbbbbbbba
abbbbbbbbbbbbbbbbbbbbbbbbbbbbbbbbbbbbbbbbbbbbbbbba
abbbbbbbbbbbbbbbbbbbbbbbbbbbbbbbbbbbbbbbbbbbbbbbbb
abbbbbbbbbbbbbbbbbbbbbbbbbbbbbbbbbbbbbbbbbbbbbbbba
abbbbbbbbbbbbbbbbbbbbbbbbbbbbbbbbbbbbbbbbbbbbbbbba
abbbbbbbbbbbbbbbbbbbbbbbbbbbbbbbbbbbbbbbbbbbbbbbba
abbbbbbbbbbbbbbbbbbbbbbbbbbbbbbbbbbbbbbbbbbbbbbbba
abbbbbbbbbbbbbbbbbbbbbbbbbbbbbbbbbbbbbbbbbbbbbbbba
abbbbbbbbbbbbbbbbbbbbbbbbbbbbbbbbbbbbbbbbbbbbbbbba
abbbbbbbbbbbbbbbbbbbbbbbbbbbbbbbbbbbbbbbbbbbbbbbba
abbbbbbbbbbbbbbbbbbbbbbbbbbbbbbbbbbbbbbbbbbbbbbbba
abbbbbbbbbbbbbbbbbbbbbbbbbbbbbbbbbbbbbbbbbbbbbbbba
abbbbbbbbbbbbbbbbbbbbbbbbbbbbbbbbbbbbbbbbbbbbbbbba
abbbbbbbbbbbbbbbbbbbbbbbbbbbbbbbbbbbbbbbbbbbbbbbba
abbbbbbbbbbbbbbbbbbbbbbbbbbbbbbbbbbbbbbbbbbbbbbbba
abbbbbbbbbbbbbbbbbbbbbbbbbbbbbbbbbbbbbbbbbbbbbbbba
abbbbbbbbbbbbbbbbbbbbbbbbbbbbbbbbbbbbbbbbbbbbbbbba
abbbbbbbbbbbbbbbbbbbbbbbbbbbbbbbbbbbbbbbbbbbbbbbba
abbbbbbbbbbbbbbbbbbbbbbbbbbbbbbbbbbbbbbbbbbbbbbbba
aaaaaaaaaabaaabbbbbbbbbbbbbbbbbbbbbbbbbbbbbbbbbbba
abbbbbbbbbbbbbbbbbbbbbbbbbbbbbbbbbbbbbbbbbbbbbbbba
abaaaaaaaaaaaabbbbbbbbbbbbbbbbbbbbbbbbbbbbbbbbbbba
abbbbbbbababaabbbbbbbbbbbbbbbbbbbbbbbbbbbbbbbbbbba
aaaaaabababababbbbbbbbbbbbbbbbbbbbbbbbbbbbbbbbbbba
abbbabbbbbabaabbbbbbbbbbbbbbbbbbbbbbbbbbbbbbbbbbba
ababaabababababbbbbbbbbbbbbbbbbbbbbbbbbbbbbbbbbbba
ababababbbbbbabbbbbbbbbbbbbbbbbbbbbbbbbbbbbbbbbbba
ababaabababababbbbbbbbbbbbbbbbbbbbbbbbbbbbbbbbbbba
ababababababbabbbbbbbbbbbbbbbbbbbbbbbbbbbbbbbbbbba
ababaabababababbbbbbbbbbbbbbbbbbbbbbbbbbbbbbbbbbba
abababbbbbbbbabbbbbbbbbbbbbbbbbbbbbbbbbbbbbbbbbbba
abababaaaaaaaabbbbbbbbbbbbbbbbbbbbbbbbbbbbbbbbbbba
abababbbbbaaabbbbbbbbbbbbbbbbbbbbbbbbbbbbbbbbbbbba
abaaaaaaabaaabbbbbbbbbbbbbbbbbbbbbbbbbbbbbbbbbbbba
abbbbbbbbbbaaaabbbbbbbbbbbbbbbbbbbbbbbbbbbbbbbbbba
abaaaabababbbbaaaaaaaaabbbbbbbbbbbbbbbbbbbbbbbbbba
abbbbababaaaabbbbbbbbbbbbbbbbbbbbbbbbbbbbbbbbbbbba
aaaabababbbbaaaaaaaaaaaaaabaaaaaaaaaaaaaaaaaaaaaaa
abbbbabaaaababbbabbbabbbabbbabbbabbbabbbabbbabbbaa
abbbbabbbbabababababababababababababababababababaa
abcbbaaaababababababababababababababababababababaa
abbbbabbbbabbbabbbabbbabbbabbbabbbabbbabbbabbbabba
aaaaaaaaaaaaaaaaaaaaaaaaaaaaaaaaaaaaaaaaaaaaaaaaaa
"}
